LLRRRLRLLRRLLRLRLRLRRLRRRLRRRLRLRRLLRLLRRRLRRLRRRLRLRRRLRRLRLRRRLRRRLRRLRLRRRLRRLRRLRRRLRLRLLRLLRLLRLRRRLRRLRRLRRRLRLRRRLRLRLRLRRRLRRRLRLRLRLRRRLRLLRRLLRLLRRLRRRLLRRRLLRRLRLRRLRLLRLLLLRRLLRRLRRLRLLLRRRLRRLRRRLRRLLRLRRRLRLLRRRLLLLRLRRRLRLRRLRRLRRLLRLRLRRLLLRRLLRLRRLRRRR

HFF = (HRR, BSG)
LJV = (CSH, GDM)
RNF = (QGT, JQL)
CCB = (FTQ, MPQ)
XKL = (HGX, SSQ)
SGN = (MTT, RJK)
MJH = (QBK, GBX)
CNP = (TNH, GHS)
BXM = (SFM, KGF)
RNK = (DJF, THX)
HMS = (JBS, QFS)
VPS = (TXK, SBS)
GBX = (VRK, QCK)
CJP = (XVL, DKG)
RGD = (NQB, NQB)
JMT = (LMD, TCD)
JDB = (LKN, VNH)
XNV = (FLR, SFV)
SDC = (SFV, FLR)
HRR = (HCK, HDM)
CXJ = (VMC, VQB)
HLQ = (CGJ, KBR)
DCQ = (JQX, FMN)
GLN = (JFG, GFD)
MKX = (JTC, RGX)
NBL = (JQM, HKC)
QKM = (QVX, VVN)
BFH = (XHJ, PFM)
SJL = (QNF, PNP)
FXF = (THN, DTL)
BXD = (GLX, SMP)
CNH = (CGP, GTN)
TNC = (BKK, BKK)
JBS = (DCL, DCL)
VQB = (KJL, BJM)
GTJ = (LMS, QBM)
KSM = (NHH, KFX)
VNA = (HRT, NPR)
SPD = (KLM, KLM)
JQM = (MDN, NPJ)
XBD = (JDQ, VQL)
HKC = (NPJ, MDN)
LGB = (VPN, NMP)
RHJ = (LSH, TSM)
RQH = (PTS, HQS)
XVL = (JVP, KRM)
RCR = (XJX, NLM)
RCP = (NRD, DMQ)
MSQ = (SKC, DMS)
VRK = (CQP, FBG)
TPZ = (SHK, QKS)
XVG = (QJX, GTJ)
XVH = (VMQ, LNG)
MHJ = (NSP, QPL)
CSH = (LFJ, VSJ)
SVJ = (VCV, QDC)
DVD = (NQG, BGV)
GJM = (RQC, SHH)
VLK = (RGD, QSQ)
LJT = (HTJ, MVQ)
HQL = (BNP, RPM)
BKT = (GTS, JCR)
SKC = (VKQ, FQR)
KDR = (MTT, RJK)
HKG = (RBH, DCN)
QNB = (TDP, QJN)
CCK = (GRP, NFQ)
FBQ = (CKD, LGG)
KMG = (QRQ, GLT)
LLX = (KGK, BST)
FLF = (LLX, RBP)
HLD = (JRB, PCT)
DMS = (FQR, VKQ)
RBJ = (GJS, JVH)
LRJ = (RPC, RJM)
XHJ = (MBM, QGM)
PTF = (CRS, LTP)
PJN = (GTJ, QJX)
VDQ = (LFC, RVC)
QSM = (KRV, XTX)
FJX = (BHG, HXR)
FNK = (SGK, GND)
HBS = (RPC, RJM)
HGR = (MHM, KLB)
MDX = (VCD, KNP)
HTS = (RTH, DJD)
MNC = (PJR, RHP)
CGK = (HPS, XVH)
GND = (HLD, TMT)
LGN = (BPX, LCP)
RVC = (BHH, XDP)
GRT = (XDF, FMP)
JDQ = (JHD, XJP)
LTV = (FPL, PBT)
TLG = (GHG, DPV)
DBR = (RQH, CRC)
RJK = (JQS, RCR)
FTQ = (NXK, HRH)
PJL = (RJB, VBD)
RTG = (QFN, GMQ)
LQN = (TGN, JPD)
QBP = (SKB, VJK)
GGM = (GTQ, PXK)
XJP = (NSD, QHM)
NCC = (JSQ, KPM)
RXR = (PJN, XVG)
GDM = (LFJ, VSJ)
LMD = (RKB, PPP)
MSB = (JSV, HCH)
FHS = (PHP, FFQ)
NRC = (JDB, LGS)
HBC = (HQL, PJP)
KFX = (VXH, THQ)
XMV = (MHC, RNF)
TGN = (XJF, BNX)
BPB = (LJL, LQC)
GLK = (MQS, SJL)
FLR = (MKC, NBX)
KTG = (SLB, KTT)
KLB = (RXR, TLS)
XBS = (DMQ, NRD)
XKX = (LKD, RFS)
QTL = (QKS, SHK)
MBM = (XBD, MRR)
VDC = (BSP, QLX)
HCM = (FMN, JQX)
DPV = (KMG, GDS)
THC = (JRF, MKX)
BNP = (BFH, LPS)
QKV = (DPH, PFX)
CRS = (HTH, QNB)
TBM = (PJR, RHP)
KVT = (TCD, LMD)
MVQ = (PLF, LNM)
KLM = (MGK, MGK)
TLS = (PJN, XVG)
VXH = (QBF, DJX)
DCL = (RQD, LCJ)
HTJ = (PLF, LNM)
CXP = (XXG, KMD)
FPL = (QKV, CBR)
XJF = (BHQ, TGL)
SHS = (CXJ, QPS)
XLV = (LJT, SRT)
SFV = (MKC, NBX)
FCP = (VKK, LXC)
BNX = (TGL, BHQ)
HCX = (XDF, FMP)
BST = (PSJ, TBF)
VPM = (VPN, NMP)
FBT = (KVT, JMT)
RPM = (LPS, BFH)
FRP = (PDN, QBV)
DMF = (LRX, NNL)
TTR = (LVB, RNX)
LSH = (BJX, CQC)
MRP = (NFQ, GRP)
VCK = (MKH, FVL)
FCK = (KSP, PSM)
HSK = (KLB, MHM)
PFM = (MBM, QGM)
MTT = (JQS, RCR)
SRJ = (NTN, VJX)
GTQ = (XTR, DMN)
ZZZ = (XRL, QKM)
CMB = (HTS, NTL)
KRG = (NDF, HLQ)
CST = (LRM, QXJ)
NQJ = (BPB, JCQ)
CRC = (HQS, PTS)
TMS = (DJK, FBT)
LTP = (QNB, HTH)
CSB = (RNG, GTX)
QDC = (HJD, QVP)
BJM = (DKF, DDK)
SSS = (QJP, CGK)
PLV = (LTM, MLC)
LDJ = (RXM, XJS)
HJG = (NRH, NCC)
SMP = (QFQ, PGX)
NPJ = (NRC, DRT)
STQ = (HTF, NVX)
LKD = (LQF, GCH)
LVL = (VDF, TMH)
DBL = (HVC, VPB)
CGP = (HXF, PFD)
AAA = (QKM, XRL)
XVX = (JBH, BXD)
JQX = (KMB, DCT)
NCH = (DSG, RVG)
NSP = (TVG, SNS)
CKD = (QBP, XRG)
SJM = (NRF, XQK)
SFM = (FHQ, BND)
LTF = (NMC, VFD)
HQS = (HKG, RGR)
JQL = (LQN, FMK)
HJV = (RBP, LLX)
LXT = (SSQ, HGX)
JTP = (KRV, XTX)
FMP = (QSM, JTP)
MDG = (BTV, FCP)
MBX = (HTF, NVX)
TMH = (CJP, PTL)
NVT = (SFM, KGF)
BVQ = (BHS, VDC)
TVG = (MSB, JFQ)
MCB = (GHS, TNH)
RTH = (CXP, NFP)
RJM = (FLF, HJV)
BHG = (VLK, BSH)
JCQ = (LQC, LJL)
SJK = (MPB, MPB)
PSS = (VNX, JKV)
CBK = (HCX, GRT)
MHM = (RXR, TLS)
JCF = (XSN, NHK)
SFH = (MCH, NQD)
MDN = (DRT, NRC)
QFQ = (JVR, PJL)
QFS = (DCL, FTZ)
BHH = (LTV, CLV)
NVX = (FHB, NBL)
BND = (RKS, MKB)
DSG = (NCD, HCN)
FMK = (TGN, JPD)
TSM = (CQC, BJX)
FTZ = (LCJ, RQD)
HRM = (SKC, DMS)
VFF = (BVQ, MSS)
GCG = (PJB, BMC)
QVP = (XFG, RTR)
VQL = (JHD, XJP)
QBV = (DBL, CRL)
PFS = (SPD, SPD)
PBT = (CBR, QKV)
JSQ = (FJX, SDN)
MKC = (RNN, CSJ)
VSJ = (HBN, DVD)
RNN = (BKT, PMV)
FVL = (TBX, VTM)
QBM = (CTP, BQM)
JHD = (QHM, NSD)
GLX = (PGX, QFQ)
LFP = (RTG, SQR)
LFC = (XDP, BHH)
FHQ = (RKS, MKB)
NMP = (QXD, RJT)
QGM = (MRR, XBD)
RHP = (MJH, VNK)
FDP = (KBJ, NLD)
NFQ = (SFH, BDK)
MLC = (PTF, KTH)
PFD = (SRJ, DPF)
VNK = (QBK, GBX)
RQD = (MSQ, HRM)
SDN = (BHG, HXR)
RXM = (PBN, CBK)
RVG = (NCD, HCN)
VGR = (JTX, TXQ)
PGX = (PJL, JVR)
XBR = (CKL, BLJ)
FQR = (XPF, VCP)
RLD = (PHS, BCT)
THQ = (QBF, DJX)
KBN = (RFS, LKD)
CQN = (XBS, RCP)
DCT = (NRM, RDR)
GRP = (SFH, BDK)
RJB = (PKG, FRR)
PSB = (XRD, TCT)
TDP = (VGR, FLB)
JBB = (BXM, NVT)
BHQ = (RBJ, DSL)
VJX = (VFF, TXL)
VRH = (GPX, PVX)
NPX = (KSH, CFG)
HHF = (CKL, BLJ)
TKV = (SBS, TXK)
LTM = (KTH, PTF)